Charities	non-profit
Cars	auto
Public awareness	non-profit
Environmental & Animal Issues	non-profit
Fast food	food
Banking & Financial Services	finance
Department Stores & Shopping Malls	retail
Advertising agencies	!
Travel Agencies	travel
Hospitals	health
Consumer & Public services	non-profit
Soft Drinks	food
Beers and Ciders	food
Coffee	food
Education	!
Household maintenance & pet products	pets
Shows	entertainment
Sports Teams & Events	sports
Website	technology
Airlines	travel
Books	entertainment
Clothing	fashion
Health & Pharmaceutical Products	health
Magazines	entertainment
Traffic safety	non-profit
TV Channels/Radio Stations and Programmes	entertainment
Against Cancer	non-profit
Catering & Fine Restaurants	food
Electronic Devices & Home Appliances	technology
Human Rights	non-profit
Pet Food	pets
SUV & Four Wheel Drive	auto
Against violence	non-profit
Ice cream & Cold desserts	food
Juice	food
Public Safety	non-profit
Sportswear	sports
Stationery	home
Supermarkets	retail
Contraceptives & Pregnancy Tests	health
Destinations (Countries & Places)	travel
Newspapers	entertainment
Oral Hygiene	health
Racial/Ethnic/Handicapped/Minority Awareness	non-profit
Restaurants	food
Washing powders & Detergents	home
Bars	retail
Book store	entertainment
Canned Food	food
Chewing-Gum	food
Home Furniture	home
Mobile Communications	technology
Portable Audio & Accessories	technology
Telecommunications Services	technology
Trucks	auto
Whiskey	food
Accessories	!
Automotive products	auto
Culture	entertainment
Hotels & Resorts	travel
Insurance	!
Mobile applications	technology
Mobile phones	technology
Museums & Libraries	travel
Paints	!
Petrol/Gas Station	auto
Photo & Video Cameras	technology
Publishing	entertainment
Real Estate	!
Sauces	food
Skin Care	fashion
Software & Multimedia Productions	entertainment
Sports and Health Clubs	health
Toys	entertainment
Against alcohol	non-profit
Against Drugs	non-profit
Airports	travel
Alcohol-free beer and Ciders	food
Apparel	fashion
Breakfast Cereals & Flakes	food
Cafe	food
Candies	food
Chocolate	food
Cinemas	entertainment
Construction & Civil Engineering	!
Government & Other Authorities	non-profit
Hair Care	fashion
Laxative	health
Leisure Parks	travel
Lottery & Gambling	entertainment
Motorcycles	auto
Online Retail & E-stores	retail
Organ Donation	non-profit
Photo Development	technology
Railways	travel
Retail	retail
Sausage and meat products	food
Soaps	health
Tableware	home
Video Games/Consoles	technology
Washing Machines	home
Wine & Champagne	food
Zoos	travel
Ð¡able/Satellite television	entertainment
Air Conditioners	home
Alarms & Locks	home
Alcoholic drinks & Tobacco	food
Anti-smoking	non-profit
Arts	travel
Automotive	auto
Baby Food	food
Baby Hygiene	health
Baking	food
Banking	finance
Batteries	home
Business equipment & services	!
Bus Lines	travel
Butter	food
Cheese	food
Chips	food
Cleaning Products	home
Confectionery & snacks	food
Cosmetics & beauty products	fashion
Credit Cards	finance
Deodorants	health
Diet Meals & Products	food
Eggs	food
Energy & Water Utilities	home
Ferries & Cruises	travel
Flowers delivery	entertainment
Gardening Instruments & Products	home
Gin	food
Grocery and Other foods	food
HIV/AIDS	non-profit
Hygiene & Personal Care Products	health
Industrial & Agriculture	!
Industrial Equipment & Agricultural Machinery	!
Insecticides	home
IT Solutions & Professional Networks	!
Jewelry	fashion
Knives	home
Lollipops	food
Makeup	fashion
Milk	food
Musical Instruments	entertainment
Non-alcoholic drinks	food
Online Financial Service	finance
Perfumes	fashion
Postal	non-profit
Pre-Cooked Meals & Frozen Food	food
Public Transport	travel
Rum	food
Sex shop	!
Shoe & Wax Polishes	fashion
Snacks	food
Spices & Condiments	food
Taxi	travel
Tissues & Towels	home
TV	entertainment
Vitamins & Diet Complements	health
Windows	home
